0,0,0,0,0,0,2,2,5,2,228
0,0,0,0,0,0,259,34,101,34,260
0,0,0,0,0,0,258,0,0,0,257
0,0,0,0,0,0,291,228,0,3,292
0,0,0,0,0,0,34,260,0,259,34
227,3,3,3,228,226,227,261,0,262,228
259,34,34,34,34,291,259,34,0,34,260
258,0,0,0,0,35,290,0,0,0,257
258,0,0,0,0,227,226,0,0,0,257
291,227,227,227,228,259,291,3,3,3,292
34,34,34,34,34,290,35,34,34,34,34