0,0,0,0,0,0,0,0,0,0,0
0,0,0,0,0,0,0,0,0,0,0
0,0,0,0,0,0,130,130,133,130,130
0,0,0,0,0,0,130,130,130,130,130
0,0,0,0,0,0,0,0,130,0,0
0,0,0,0,0,0,0,0,130,0,0
0,0,0,0,0,0,0,0,130,0,0
130,130,130,130,130,0,130,130,130,130,130
130,130,130,130,130,130,130,130,130,130,130
130,130,130,130,130,0,130,130,130,130,130
0,0,0,0,0,0,0,0,0,0,0